..P...........
.....O....W...
WPPWPWPPPPPPP.
......P.P.P.WW
.P....WWWP.PP.
...W........W.